11111111111111111111
10000000000C0C000001
10000000000000000001
11011111110000000001
1P0011E0000000000001
11111111111111111111
