1111111111111
10010000000C1
1000011111111
1P00110000101
10001E0010001
1111111111111