1111111111111
10010000000C1
1000011111101
1P00110000101
100C1E00100011
1111111111111