111111111111111111111111111
1P1000100010001000100010001
101010101010101010101010101
101010101010101010101010101
101010101010101010101010101
101010101010101010101010101
101010101010101010101010101
101010101010101010101010101
101010101010101010101010101
101010101010101010101010101
101010101010101010101010101
100010001000100010001000101
1111111C11111111111011111E1
111111111111111111111111111
